6656
448
7
104
0	1	0	2	3	4	3	5	0	1	2	3	4	3	4	3	4	3	4	3	5	6	0	6	0	1	6	0	1	1	6	0	6	6	6	1	0	6	1	2	3	5	1	7	8	8	8	8	8	8	8	8	8	8	8	8	8	8	8	8	8	8	8	8	8	8	8	8	8	8	8	8	8	8	8	8	8	8	8	8	8	9	9	9	9	9	9	9	9	9	9	9	9	9	9	9	9	9	9	10	6	6	6	6	
1	6	6	11	12	13	12	14	6	6	11	12	13	12	13	12	13	12	13	12	14	0	1	6	6	6	0	1	0	0	6	6	1	1	6	0	6	6	6	11	12	14	0	15	15	15	15	15	15	15	15	15	15	15	15	15	15	15	15	16	16	16	16	16	15	15	15	15	15	16	16	16	16	16	16	16	16	16	15	15	16	17	8	8	8	8	8	8	8	8	8	8	8	8	8	8	8	8	8	8	18	19	20	21	
6	22	23	24	22	24	22	22	23	23	23	24	22	23	23	24	24	22	23	23	22	23	23	24	6	1	6	6	22	23	23	23	24	6	6	6	6	22	23	23	23	23	24	25	25	25	25	25	25	25	25	25	25	25	25	25	25	25	25	15	15	15	15	15	25	25	25	25	25	16	15	15	16	16	16	16	16	15	25	25	16	15	15	16	16	16	16	16	16	16	16	16	16	16	15	15	15	15	16	16	26	27	28	29	
6	25	25	25	25	25	25	25	25	25	25	25	25	25	25	25	25	25	25	25	25	25	25	25	6	6	6	6	25	25	25	25	25	6	6	6	6	25	25	25	25	25	25	25	25	30	30	30	30	30	30	30	30	30	30	30	30	30	25	25	25	25	25	25	25	30	30	30	30	15	25	25	16	15	15	16	16	25	25	30	16	25	25	15	15	15	15	16	16	16	16	16	15	15	25	25	25	25	15	16	31	32	28	29	
33	30	30	30	30	25	25	25	30	30	30	30	30	25	25	30	30	30	30	30	34	34	34	30	33	33	33	33	30	30	30	30	30	33	33	33	33	30	30	30	30	30	30	30	30	30	30	34	34	30	25	25	25	25	25	25	25	30	30	30	30	30	30	30	30	30	34	30	25	25	25	30	16	25	25	15	15	30	30	34	16	30	25	25	25	25	25	16	16	15	15	16	25	25	30	34	34	34	25	15	35	36	37	38	
39	40	40	40	41	30	30	30	25	30	30	25	42	30	30	43	40	41	30	30	44	44	44	43	45	33	33	39	40	40	40	40	40	45	33	33	39	40	41	30	30	30	30	30	30	30	30	44	44	42	30	30	30	30	30	30	30	30	30	30	25	25	30	25	25	30	44	30	30	30	30	30	16	30	25	25	25	30	30	44	16	30	30	30	30	30	30	15	16	25	25	16	30	30	30	44	44	30	30	25	46	47	28	29	
33	33	33	33	48	49	49	49	50	51	51	52	53	49	49	54	33	48	50	51	51	52	49	54	33	33	33	33	33	33	33	33	33	33	33	33	33	33	48	49	49	49	49	50	51	51	51	52	49	53	49	49	49	50	51	55	25	25	25	25	30	30	30	30	30	30	30	30	30	30	30	30	16	25	30	30	30	30	25	30	16	30	30	30	30	25	25	25	16	30	30	16	30	30	25	25	25	25	25	25	25	56	57	29	
