3328
240
104
7
0 1 0 2 3 4 3 5 0 1 2 3 4 3 4 3 4 3 4 3 5 6 0 6 0 1 6 0 1 1 6 0 6 6 6 1 0 6 1 2 3 5 1 7 8 8 8 8 8 8 8 8 8 8 8 8 8 8 8 8 8 8 8 8 8 8 8 8 8 8 8 8 8 8 8 8 8 8 8 8 8 8 8 8 8 8 8 8 8 8 8 8 8 8 8 8 8 8 8 9 6 6 6 6 
10 11 12 13 14 15 14 16 12 11 13 14 15 14 15 14 15 14 15 14 16 0 10 6 12 11 0 10 17 17 6 12 1 1 6 17 12 6 11 13 14 16 17 18 19 19 19 19 19 19 19 19 19 19 19 19 19 19 19 19 19 19 19 19 19 19 19 19 19 19 19 19 19 19 19 19 19 19 19 19 19 20 21 21 21 21 21 21 21 21 21 21 21 21 21 21 21 21 21 22 23 24 25 26 
11 27 28 29 30 31 30 27 28 28 32 33 34 35 36 33 31 30 36 35 27 37 38 39 6 1 12 11 40 37 28 28 41 11 6 12 6 27 28 32 35 28 42 43 43 43 43 43 43 43 43 43 43 43 43 43 43 43 43 44 44 44 44 44 43 43 43 43 43 44 44 44 44 44 44 44 44 44 43 43 44 45 19 19 19 19 19 19 19 19 19 19 19 19 19 19 19 19 19 19 46 47 48 49 
6 50 51 52 50 52 50 50 51 51 51 52 50 51 51 52 52 50 51 51 50 51 51 52 53 54 53 53 50 51 51 51 52 53 53 53 53 50 51 51 51 51 52 55 55 56 56 56 56 56 56 56 56 56 56 56 56 56 55 43 43 43 43 43 55 56 56 56 56 44 43 43 44 44 44 44 44 43 55 56 44 43 43 44 44 44 44 44 44 44 44 44 44 44 43 43 43 43 44 44 57 58 59 60 
61 56 56 56 56 55 55 55 56 56 56 56 56 55 55 56 56 56 56 56 56 56 56 56 62 63 63 64 56 56 56 56 56 62 63 63 64 56 56 56 56 56 56 56 56 65 65 65 65 65 66 66 66 66 66 66 66 65 56 56 56 56 56 56 56 65 65 65 66 43 55 56 44 43 43 44 44 56 56 65 44 56 55 43 43 43 43 44 44 44 44 44 43 43 56 56 56 56 43 44 67 68 69 70 
71 65 65 65 65 56 56 56 66 65 65 66 65 56 56 65 65 65 65 65 72 72 72 65 73 74 74 71 65 65 65 65 65 73 74 74 71 65 65 65 65 65 65 65 65 65 65 72 72 65 56 56 56 56 56 56 56 65 65 65 66 66 65 66 66 65 72 65 56 56 56 65 44 56 55 43 43 65 65 72 44 65 56 56 56 56 56 44 44 43 43 44 56 56 65 72 72 75 56 43 76 77 59 60 
78 79 79 79 80 81 81 81 82 66 66 83 84 81 81 85 79 80 86 66 66 87 81 85 88 74 74 78 79 79 79 79 79 88 74 74 78 79 80 81 81 81 81 86 66 66 66 87 81 84 81 81 81 86 66 66 66 66 66 66 56 56 65 56 56 65 65 65 65 65 65 65 44 66 56 56 56 65 66 65 44 65 65 65 65 66 66 43 44 56 56 44 65 65 66 66 66 66 66 55 89 90 91 60 
