6656
480
7
104
0	1	0	2	3	4	3	5	0	1	2	3	4	3	4	3	4	3	4	3	5	6	0	6	0	1	6	0	1	1	6	0	6	6	6	1	0	6	1	2	3	5	1	7	8	8	8	8	8	8	8	8	8	8	8	8	8	8	8	8	8	8	8	8	8	8	8	8	8	8	8	8	8	8	8	8	8	8	8	8	8	8	8	8	8	8	8	8	8	8	8	8	8	8	8	8	8	8	8	9	6	6	6	6	
10	11	12	13	14	15	14	16	12	11	13	14	15	14	15	14	15	14	15	14	16	0	10	6	12	11	0	10	17	17	6	12	1	1	6	17	12	6	11	13	14	16	17	18	19	19	19	19	19	19	19	19	19	19	19	19	19	19	19	19	19	19	19	19	19	19	19	19	19	19	19	19	19	19	19	19	19	19	19	19	19	20	21	21	21	21	21	21	21	21	21	21	21	21	21	21	21	21	21	22	23	24	25	26	
11	27	28	29	30	31	30	27	28	28	32	33	34	35	36	33	31	30	36	35	27	37	38	39	6	1	12	11	40	37	28	28	41	11	6	12	6	27	28	32	35	28	42	43	43	43	43	43	43	43	43	43	43	43	43	43	43	43	43	44	44	44	44	44	43	43	43	43	43	44	44	44	44	44	44	44	44	44	43	43	44	45	19	19	19	19	19	19	19	19	19	19	19	19	19	19	19	19	19	19	46	47	48	49	
6	50	51	52	50	52	50	50	51	51	51	52	50	51	51	52	52	50	51	51	50	51	51	52	6	11	6	6	50	51	51	51	52	6	6	6	6	50	51	51	51	51	52	53	53	54	54	54	54	54	54	54	54	54	54	54	54	54	53	43	43	43	43	43	53	54	54	54	54	44	43	43	44	44	44	44	44	43	53	54	44	43	43	44	44	44	44	44	44	44	44	44	44	44	43	43	43	43	44	44	55	56	57	58	
59	54	54	54	54	53	53	53	54	54	54	54	54	53	53	54	54	54	54	54	54	54	54	54	59	59	59	59	54	54	54	54	54	59	59	59	59	54	54	54	54	54	54	54	54	60	60	60	60	60	61	61	61	61	61	61	61	60	54	54	54	54	54	54	54	60	60	60	61	43	53	54	44	43	43	44	44	54	54	60	44	54	53	43	43	43	43	44	44	44	44	44	43	43	54	54	54	54	43	44	62	63	64	65	
66	60	60	60	60	54	54	54	61	60	60	61	60	54	54	60	60	60	60	60	67	67	67	60	68	69	69	66	60	60	60	60	60	68	69	69	66	60	60	60	60	60	60	60	60	60	60	67	67	60	54	54	54	54	54	54	54	60	60	60	61	61	60	61	61	60	67	60	54	54	54	60	44	54	53	43	43	60	60	67	44	60	54	54	54	54	54	44	44	43	43	44	54	54	60	67	67	70	54	43	71	72	57	58	
73	74	74	74	75	76	76	76	77	61	61	78	79	76	76	80	74	75	81	61	61	82	76	80	83	69	69	73	74	74	74	74	74	83	69	69	73	74	75	76	76	76	76	81	61	61	61	82	76	79	76	76	76	81	61	61	61	61	61	61	54	54	60	54	54	60	60	60	60	60	60	60	44	61	54	54	54	60	61	60	44	60	60	60	60	61	61	43	44	54	54	44	60	60	61	61	61	61	61	53	84	85	86	58
