6656
448
7
104
0	1	0	2	3	4	3	5	0	1	2	3	4	3	4	3	4	3	4	3	5	6	0	6	0	1	6	0	1	1	6	0	6	6	6	1	0	6	1	2	3	5	1	7	8	8	8	8	8	8	8	8	8	8	8	8	8	8	8	8	8	8	8	8	8	8	8	8	8	8	8	8	8	8	8	8	8	8	8	8	8	9	9	9	9	9	9	9	9	9	9	9	9	9	9	9	9	9	9	10	6	6	6	6	
1	6	6	11	12	13	12	14	6	6	11	12	13	12	13	12	13	12	13	12	14	0	1	6	6	6	0	1	0	0	6	6	1	1	6	0	6	6	6	11	12	14	0	15	15	15	15	15	15	15	15	15	15	15	15	15	15	15	15	16	16	16	16	16	15	15	15	15	15	16	16	16	16	16	16	16	16	16	15	15	16	17	8	8	8	8	8	8	8	8	8	8	8	8	8	8	8	8	8	8	18	6	6	6	
6	19	20	21	19	21	19	19	20	20	20	21	19	20	20	21	21	19	20	20	19	20	20	21	6	1	6	6	19	20	20	20	21	6	6	6	6	19	20	20	20	20	21	22	22	22	22	22	22	22	22	22	22	22	22	22	22	22	22	15	15	15	15	15	22	22	22	22	22	16	15	15	16	16	16	16	16	15	22	22	16	15	15	16	16	16	16	16	16	16	16	16	16	16	15	15	15	15	16	16	23	6	6	6	
6	22	22	22	22	22	22	22	22	22	22	22	22	22	22	22	22	22	22	22	22	22	22	22	6	6	6	6	22	22	22	22	22	6	6	6	6	22	22	22	22	22	22	22	22	24	24	24	24	24	24	24	24	24	24	24	24	24	22	22	22	22	22	22	22	24	24	24	24	15	22	22	16	15	15	16	16	22	22	24	16	22	22	15	15	15	15	16	16	16	16	16	15	15	22	22	22	22	15	16	23	6	6	6	
25	24	24	24	24	22	22	22	24	24	24	24	24	22	22	24	24	24	24	24	26	26	26	24	25	25	25	25	24	24	24	24	24	25	25	25	25	24	24	24	24	24	24	24	24	24	24	26	26	24	22	22	22	22	22	22	22	24	24	24	24	24	24	24	24	24	26	24	22	22	22	24	16	22	22	15	15	24	24	26	16	24	22	22	22	22	22	16	16	15	15	16	22	22	24	26	26	26	22	15	23	6	6	6	
27	28	28	28	29	24	24	24	22	24	24	22	30	24	24	31	28	29	24	24	32	32	32	31	33	25	25	27	28	28	28	28	28	33	25	25	27	28	29	24	24	24	24	24	24	24	24	32	32	30	24	24	24	24	24	24	24	24	24	24	22	22	24	22	22	24	32	24	24	24	24	24	16	24	22	22	22	24	24	32	16	24	24	24	24	24	24	15	16	22	22	16	24	24	24	32	32	24	24	22	34	6	6	6	
25	25	25	25	35	36	36	36	37	38	38	39	40	36	36	41	25	35	37	38	38	39	36	41	25	25	25	25	25	25	25	25	25	25	25	25	25	25	35	36	36	36	36	37	38	38	38	39	36	40	36	36	36	37	38	42	22	22	22	22	24	24	24	24	24	24	24	24	24	24	24	24	16	22	24	24	24	24	22	24	16	24	24	24	24	22	22	22	16	24	24	16	24	24	22	22	22	22	22	22	22	43	6	6	
