7680
448
7
120
0	0	1	1	2	3	4	4	4	4	4	5	4	4	4	4	4	5	4	4	4	4	4	5	4	4	4	4	4	4	4	6	4	6	4	6	4	4	4	4	4	4	4	4	4	4	4	4	4	5	4	4	4	4	4	4	4	4	4	5	4	4	4	4	4	5	4	4	4	4	4	4	4	4	4	6	4	6	4	6	4	4	4	4	4	4	4	4	4	4	5	7	8	8	8	8	8	8	8	7	7	0	1	1	1	9	10	11	10	10	10	11	12	11	10	10	11	13	14	15	
0	1	0	16	2	17	18	18	18	18	18	19	20	20	18	18	18	2	18	21	20	21	18	19	0	0	16	0	1	0	0	22	1	22	0	22	18	18	18	23	24	24	24	23	18	18	18	18	18	25	18	18	18	24	24	18	18	18	18	25	18	18	18	18	18	25	18	18	18	18	26	27	18	18	28	22	11	22	11	22	18	18	18	18	28	28	28	18	18	18	25	3	29	30	31	32	33	34	29	3	3	16	0	1	16	9	10	10	10	10	12	10	11	10	10	11	10	35	36	37	
16	1	16	16	38	38	39	39	39	39	39	40	41	41	42	39	39	38	39	39	11	39	43	40	44	16	0	1	16	16	1	22	0	22	16	22	39	39	43	45	41	41	41	45	42	39	39	39	39	2	39	39	39	11	11	46	47	47	48	2	46	47	47	48	39	2	39	49	50	39	51	52	39	39	53	45	41	45	41	45	42	39	39	39	23	23	23	39	39	39	2	17	54	55	56	57	58	59	54	17	17	0	1	1	11	9	10	10	10	11	10	10	10	11	10	10	60	61	62	63	
11	53	41	41	64	64	39	39	65	66	66	67	66	66	68	39	39	64	39	43	41	42	65	67	68	16	23	23	16	53	41	45	41	45	41	45	69	42	65	70	66	66	66	70	68	39	39	39	65	71	39	39	39	53	41	72	73	73	74	2	75	73	73	74	39	2	39	51	52	39	65	66	76	39	65	70	66	70	66	70	68	39	39	43	45	45	45	42	39	39	2	2	39	39	77	77	77	39	39	2	2	16	1	16	16	11	10	11	10	11	11	10	11	10	11	11	78	79	80	81	
66	66	66	66	67	67	66	82	83	24	24	24	24	24	84	39	39	64	39	65	66	68	83	20	84	53	45	45	41	85	66	70	66	70	66	70	66	82	83	24	24	24	24	24	84	39	39	65	76	38	39	43	69	85	66	82	49	50	39	86	49	50	49	50	39	86	39	65	66	76	39	39	39	39	83	24	24	24	24	24	84	43	69	85	70	70	70	82	39	39	38	38	39	39	11	11	11	23	39	38	19	1	16	1	16	53	41	41	41	41	41	41	41	41	41	44	87	88	89	90	
91	91	91	91	91	91	91	92	41	41	41	41	41	41	41	85	66	67	82	41	41	41	41	41	41	85	70	70	66	93	91	91	91	91	91	91	91	92	41	41	41	41	41	41	41	69	69	69	69	94	69	85	66	93	91	92	51	52	39	64	51	52	51	52	39	64	39	39	39	39	39	39	39	39	53	41	41	41	41	41	41	85	66	93	91	91	91	92	69	69	94	94	69	69	41	41	41	45	69	94	40	41	41	41	41	85	66	66	66	66	66	66	66	66	95	96	95	96	97	98	
99	100	99	100	99	100	99	101	102	102	102	102	102	102	102	103	91	91	101	102	102	102	102	102	102	103	99	100	99	100	99	100	99	100	99	100	99	101	102	102	102	102	102	102	102	102	102	102	102	102	102	103	99	100	99	101	102	102	102	102	102	102	102	102	102	102	102	102	102	102	102	102	104	39	105	102	102	102	102	102	102	103	99	100	99	100	99	101	66	66	67	67	66	66	66	66	66	70	66	67	67	66	66	66	66	93	100	99	100	99	100	99	100	99	106	107	106	107	100	108	
